11111111111111111111111111
1E0000000000C00000C0000001
10100100000001010010010101
10100010010100010010010101
101000C0010100010010010101
10100010010100010010010101
1000001001C100010010010101
10100010011111110010010101
1010001001C100010010010101
10100010010100010010010101
10100010010100010010010101
10100010010100010010010101
10100010010100010010010101
10100010010100010010010101
1P00000C0C00000000000000C1
11111111111111111111111111
